1111111111111111111111111111111111
1E00000000000000000000000000000001
1000000000000000000000000101011101
1000000000000000000000000101000101
1000000000000000000000000111011101
1000000000000000000000000001010001
1000000000000000000000000001011101
1000000000000000000000000000000001
1000000000000001000000000000000001
1000000000000C11000000000000000001
1000000000000111000000000000000001
10P0000000001111C000000000000000C1
1111111111111111111111111111111111
