11111111111111111111
100000000000000000C1
10000000000101011101
10000000000101000101
10000000000111011101
10000000X00001010001
10000000100001011101
10000001100000000001
10000011101111111111
1CP00111100E000000C1
11111111111111111111
