1111111111111111111111111111111111
1E00000000000000000000000000000001
1000000000000000000000000101011101
1000000000000000000000000101000101
1C00000000000000000000000111011101
1P00000000000000000000000001010001
1000000000000000000000000001011101
1000000000000000000000000000000001
1000000000000000000000000000000001
1000000000000000000000000000000001
1000000000000000000000000000000001
1000000000000000000000000000000001
1000000010000000000000000000000001
1000000110000000000000000000000001
1000001110000000000000000000000001
1000011110000000000000000000000001
1111111111111111111111111111111111
