1111111111111111111111111111111111
10000000000000000000000000000000C1
1000000000000000000000000101011101
1000000000000000000000000101000101
1000000000000000000000000111011101
1000000000000000000000000001010001
1000000000000000000000000001011101
100000000000000X000000000000000001
1000000000000001000000000000000001
1000000000000C11000000000000000001
1000000000000111000000000000000001
1CP0000000001111C000000000000000E1
1111111111111111111111111111111111
