1111111111111
1000000000001
1000011111001
10P00000C10E1
1111111111111
