1111111111111
1000000000001
1000011111101
1P0X00E00C1C1
1111111111111
