1111111111111
1000000000001
1000011111101
1P0000E00C101
1111111111111
