1111111111111
10E0000000001
1000011111001
10P00000C1001
1111111111111
